00000000
01100000
00000010
00000010
00110000
00000000
11001000
00001000
